00 00 00 00 00 00 00 00 00 00 00 00 00 00 00 00 00 00 00 00 00 00 00 00 00 00 00 00 00 00 00 00 00 00 00 00 00 00 00 00 00 00 00 00 00 00 00 00 00 00
00 00 00 00 00 00 00 00 00 00 00 00 00 00 00 00 00 00 00 00 00 00 00 00 00 00 00 00 00 00 00 00 00 00 00 00 00 00 00 00 00 00 00 00 00 00 00 00 00 00
00 00 00 00 00 00 00 00 00 00 00 00 00 00 00 00 00 00 00 00 00 00 00 00 00 00 00 00 00 00 00 00 00 00 00 00 00 00 00 00 00 00 00 00 00 00 00 00 00 00
00 00 00 00 00 00 00 00 00 00 00 00 00 00 00 00 00 00 00 00 00 00 00 00 00 00 00 00 00 00 00 00 00 00 00 00 00 00 00 00 00 00 00 00 00 00 00 00 00 00
00 00 00 00 00 00 00 00 00 00 00 00 00 00 00 00 00 00 00 00 00 00 00 00 00 00 00 00 00 00 00 00 00 00 00 00 00 00 00 00 00 00 00 00 00 00 00 00 00 00
00 00 00 00 00 00 00 00 00 00 00 00 00 00 00 00 00 00 00 00 00 00 00 00 00 00 00 00 00 00 00 00 00 00 00 00 00 00 00 00 00 00 00 00 00 00 00 00 00 00
00 00 00 00 00 00 00 10 08 08 08 08 08 08 08 08 08 08 08 08 08 08 08 08 08 08 08 08 08 08 08 08 08 08 08 08 08 08 08 08 08 08 08 08 08 11 00 00 00 00
00 00 00 00 00 00 00 06 15 15 15 15 15 15 15 15 15 15 15 15 15 15 15 15 15 15 15 15 15 15 15 15 15 15 15 15 15 15 15 15 15 15 34 34 34 05 00 00 00 00
00 00 00 00 00 00 00 06 15 15 15 15 15 15 15 15 15 15 15 15 15 15 15 15 15 15 15 15 15 15 15 15 15 15 15 15 15 15 15 15 15 15 34 34 34 05 00 00 00 00
00 00 00 00 00 00 00 06 15 15 15 15 15 15 15 15 15 15 15 15 15 15 15 15 15 15 15 15 15 15 15 15 15 15 15 15 15 15 15 15 15 15 34 34 34 05 00 00 00 00
00 00 00 00 00 00 00 06 15 15 15 15 15 15 15 15 15 15 15 15 15 15 15 15 15 15 15 15 15 15 15 15 15 15 15 15 15 15 15 15 15 15 34 34 34 05 00 00 00 00
00 00 00 00 10 08 08 09 15 15 15 15 15 15 15 15 15 15 15 15 15 15 15 15 15 15 15 15 15 15 15 15 34 34 34 34 34 34 34 34 15 15 34 34 34 05 00 00 00 00
00 00 00 00 06 34 34 34 15 15 15 15 15 15 15 15 15 15 15 15 15 15 15 15 15 15 15 15 15 15 34 34 34 29 29 29 29 29 29 34 34 15 34 34 34 05 00 00 00 00
00 00 00 00 06 34 34 34 15 15 15 15 15 15 15 15 15 15 15 15 15 34 34 34 34 34 34 34 34 34 34 29 29 29 31 31 31 31 29 34 15 15 34 34 34 05 00 00 00 00
00 00 00 00 06 34 34 34 15 15 15 15 15 15 15 15 15 15 15 15 15 34 25 23 23 23 23 23 23 23 23 29 31 31 31 31 31 31 29 34 15 34 34 34 34 05 00 00 00 00
00 00 00 00 06 34 34 34 15 15 15 15 15 15 15 15 15 15 15 15 15 34 21 16 16 16 16 16 16 16 16 16 31 31 31 31 31 31 29 34 15 15 34 34 34 05 00 00 00 00
00 00 00 00 06 34 34 34 15 15 15 15 15 15 15 15 15 15 15 15 15 34 21 16 17 18 18 18 18 18 18 29 31 31 31 31 31 31 29 34 34 15 34 34 34 05 00 00 00 00
00 00 00 00 06 34 34 34 15 15 15 15 15 15 15 15 15 15 15 15 15 34 21 16 20 34 34 34 34 34 34 29 29 29 31 31 31 31 29 34 15 15 34 34 34 05 00 00 00 00
00 00 00 00 06 34 34 34 15 15 15 15 15 15 15 15 15 15 15 15 15 34 21 16 20 34 02 03 03 04 34 34 34 29 29 29 29 29 29 34 15 34 34 34 34 05 00 00 00 00
00 00 00 00 06 34 34 34 15 15 15 15 15 15 15 15 15 15 15 15 15 34 21 16 20 34 05 00 00 06 34 34 34 34 34 34 34 34 34 34 15 15 34 34 34 05 00 00 00 00
00 00 00 00 06 34 34 34 15 15 15 15 15 15 15 15 15 15 15 15 15 34 21 16 20 34 05 00 00 06 34 34 34 34 34 34 34 34 34 34 34 15 34 34 34 05 00 00 00 00
00 00 00 00 06 34 34 34 34 34 15 15 15 15 15 15 15 15 15 15 15 34 21 16 20 34 07 08 08 09 34 34 34 34 34 34 34 32 15 15 15 15 34 34 34 05 00 00 00 00
00 00 00 00 06 34 34 34 34 34 15 15 15 15 15 15 15 15 15 15 15 34 15 18 15 34 34 15 15 34 34 34 34 15 15 34 34 15 15 15 15 15 34 34 34 05 00 00 00 00
00 00 00 00 06 34 34 34 34 34 15 15 15 15 15 15 15 15 15 15 15 15 15 15 15 34 34 15 15 34 34 34 15 15 15 15 15 15 15 15 15 15 34 34 34 05 00 00 00 00
00 00 00 00 06 34 34 34 34 34 15 15 15 15 15 15 15 15 15 15 15 15 15 15 15 15 15 15 15 15 15 15 15 15 15 15 15 15 15 34 34 34 02 03 03 13 00 00 00 00
00 00 00 00 12 03 03 04 34 34 15 15 15 15 15 15 15 15 15 15 15 15 15 15 15 15 15 15 15 15 15 15 15 15 15 15 15 15 15 15 15 15 05 00 00 00 00 00 00 00
00 00 00 00 00 00 00 06 34 34 15 15 15 15 15 15 15 15 15 15 15 15 15 15 15 15 15 15 15 15 15 15 15 15 15 15 15 15 15 15 15 15 05 00 00 00 00 00 00 00
00 00 00 00 00 00 00 06 15 34 15 15 15 15 15 15 15 15 15 15 15 15 15 15 15 15 15 15 15 15 15 15 15 15 15 15 15 15 15 15 15 15 05 00 00 00 00 00 00 00
00 00 00 00 00 00 00 06 15 34 15 15 15 15 15 15 15 15 15 15 15 15 15 15 15 15 15 15 15 15 15 15 15 15 15 15 15 15 15 15 15 15 05 00 00 00 00 00 00 00
00 00 00 00 00 00 00 06 15 34 15 15 15 15 15 15 15 15 15 15 15 15 15 15 15 15 15 15 15 15 15 15 15 15 15 15 15 15 15 15 15 15 05 00 00 00 00 00 00 00
00 00 00 00 00 00 00 06 15 15 15 15 15 15 15 15 15 15 15 15 15 15 15 15 15 15 15 15 15 15 15 15 15 15 15 15 15 15 15 15 15 15 05 00 00 00 00 00 00 00
00 00 00 00 00 00 00 06 15 15 15 15 15 15 15 15 15 15 15 15 15 15 15 15 15 15 15 15 15 15 15 15 15 15 15 15 15 15 15 15 15 15 05 00 00 00 00 00 00 00
00 00 00 00 00 00 00 06 15 15 15 15 15 15 15 15 15 15 15 15 15 15 15 15 15 15 15 15 15 15 15 15 15 15 15 15 15 15 15 15 15 15 05 00 00 00 00 00 00 00
00 00 00 00 00 00 00 06 15 15 15 15 15 15 15 15 15 15 15 15 15 15 15 15 15 15 15 15 15 15 15 15 15 15 15 15 15 15 15 15 15 15 05 00 00 00 00 00 00 00
00 00 00 00 00 00 00 06 15 15 15 15 15 15 15 15 15 15 15 15 15 15 15 15 15 15 15 15 15 15 15 15 15 15 15 15 15 15 15 15 15 15 05 00 00 00 00 00 00 00
00 00 00 00 00 00 00 06 15 15 15 15 15 15 15 15 15 15 15 15 15 15 15 15 15 15 15 15 15 15 15 15 15 15 15 15 15 15 15 15 15 15 05 00 00 00 00 00 00 00
00 00 00 00 00 00 00 06 15 15 15 15 15 15 15 15 15 15 15 15 15 15 15 15 15 15 15 15 15 15 15 15 15 15 15 15 15 15 15 15 15 15 05 00 00 00 00 00 00 00
00 00 00 00 00 00 00 06 15 15 15 15 15 15 15 15 15 15 15 15 15 15 15 15 15 15 15 15 15 15 15 15 15 15 15 15 15 15 15 15 15 15 05 00 00 00 00 00 00 00
00 00 00 00 00 00 00 06 15 15 15 15 15 15 15 15 15 15 15 15 15 15 15 15 15 15 15 15 15 15 15 15 15 15 15 15 15 15 15 15 15 15 05 00 00 00 00 00 00 00
00 00 00 00 00 00 00 06 15 15 15 15 15 15 15 15 15 15 15 15 15 15 15 15 15 15 15 15 15 15 15 15 15 15 15 15 15 15 15 15 15 15 05 00 00 00 00 00 00 00
00 00 00 00 00 00 00 06 15 15 15 15 15 15 15 15 15 15 15 15 15 15 15 15 15 15 15 15 15 15 15 15 15 15 15 15 15 15 15 15 15 15 05 00 00 00 00 00 00 00
00 00 00 00 00 00 00 06 15 15 15 15 15 15 15 15 15 15 15 15 15 15 15 15 15 15 15 15 15 15 15 15 15 15 15 15 15 15 15 15 15 15 05 00 00 00 00 00 00 00
00 00 00 00 00 00 00 06 15 15 15 15 15 15 15 15 15 15 15 15 15 15 15 15 15 15 15 15 15 15 15 15 15 15 15 15 15 15 15 15 15 15 05 00 00 00 00 00 00 00
00 00 00 00 00 00 00 12 03 03 03 03 03 03 03 03 03 03 03 03 03 03 03 03 03 03 03 03 03 03 03 03 03 03 03 03 03 03 03 03 03 03 13 00 00 00 00 00 00 00
00 00 00 00 00 00 00 00 00 00 00 00 00 00 00 00 00 00 00 00 00 00 00 00 00 00 00 00 00 00 00 00 00 00 00 00 00 00 00 00 00 00 00 00 00 00 00 00 00 00
00 00 00 00 00 00 00 00 00 00 00 00 00 00 00 00 00 00 00 00 00 00 00 00 00 00 00 00 00 00 00 00 00 00 00 00 00 00 00 00 00 00 00 00 00 00 00 00 00 00
00 00 00 00 00 00 00 00 00 00 00 00 00 00 00 00 00 00 00 00 00 00 00 00 00 00 00 00 00 00 00 00 00 00 00 00 00 00 00 00 00 00 00 00 00 00 00 00 00 00
00 00 00 00 00 00 00 00 00 00 00 00 00 00 00 00 00 00 00 00 00 00 00 00 00 00 00 00 00 00 00 00 00 00 00 00 00 00 00 00 00 00 00 00 00 00 00 00 00 00
00 00 00 00 00 00 00 00 00 00 00 00 00 00 00 00 00 00 00 00 00 00 00 00 00 00 00 00 00 00 00 00 00 00 00 00 00 00 00 00 00 00 00 00 00 00 00 00 00 00
00 00 00 00 00 00 00 00 00 00 00 00 00 00 00 00 00 00 00 00 00 00 00 00 00 00 00 00 00 00 00 00 00 00 00 00 00 00 00 00 00 00 00 00 00 00 00 00 00 00
