01 00 00 00 01 00 00 00 01 00 00 00 01 00 00 00
00 10 08 08 08 08 08 08 08 08 08 08 08 08 11 00
00 06 15 15 15 15 15 15 29 29 29 29 29 29 05 00
01 06 15 25 23 23 23 29 29 31 31 31 31 29 05 01
00 06 15 21 16 16 16 16 16 31 31 31 31 29 05 00
00 06 15 21 16 17 18 29 29 31 31 31 31 29 05 00
00 06 15 21 16 20 15 15 29 29 29 29 29 29 05 00
01 06 15 21 16 20 15 15 15 15 15 15 15 15 05 01
00 06 15 27 18 28 15 15 15 15 15 15 15 15 05 00
00 06 15 15 15 15 15 15 15 15 15 15 15 15 05 00
00 12 03 03 03 03 03 03 03 03 03 03 03 03 13 00
01 00 00 00 01 00 00 00 01 00 00 00 01 00 00 00